"ah" = (/obj/structure/machinery/gear{id = null},/obj/structure/platform/strata/metal{dir = 8},/turf/open/floor/prison/trim/red{dir = 1},/area/space)
"bj" = (/turf/closed/wall/rock/orange,/area/space)
"bS" = (/turf/open/floor/prison/trim/red,/area/space)
"cW" = (/turf/open/floor/kutjevo/colors/red/edge{dir = 4},/area/space)
"dC" = (/turf/open/floor/plating/plating_catwalk/strata,/area/space)
"fm" = (/obj/structure/platform/strata/metal{dir = 4},/obj/structure/bed/chair/dropship/passenger{dir = 8; pixel_x = -4},/turf/open/floor/engine,/area/space)
"fs" = (/obj/structure/platform/strata/metal{dir = 8},/obj/structure/bed/chair/dropship/passenger{dir = 4; pixel_x = 4},/turf/open/floor/engine,/area/space)
"gl" = (/turf/open/floor/kutjevo/colors/green/inner_corner{dir = 1},/area/space)
"gx" = (/turf/open/organic/grass,/area/space)
"gY" = (/turf/open/asphalt/cement{icon_state = "cement1"},/area/space)
"hb" = (/turf/open/floor/kutjevo/colors/blue/edge{dir = 4},/area/space)
"hD" = (/obj/structure/platform/strata/metal{dir = 1; pixel_y = 9},/obj/structure/bed/chair/dropship/passenger,/turf/open/floor/engine,/area/space)
"hF" = (/turf/open/floor/kutjevo/colors/red/edge,/area/space)
"je" = (/obj/structure/bed,/obj/item/bedsheet/blue,/turf/open/floor/kutjevo/colors/blue/edge{dir = 4},/area/space)
"jg" = (/turf/closed/wall/r_wall/bunker{hull = 1},/area/space)
"jK" = (/obj/structure/machinery/cm_vending/sorted/cargo_guns/squad{density = 0; hackable = 0; hacked = 1; pixel_y = -30; req_access = null; req_one_access = null; req_one_access_txt = null; vend_x_offset = 0; vend_y_offset = 0},/turf/open/floor/kutjevo/colors/red/edge{dir = 9},/area/space)
"kT" = (/turf/open/floor/kutjevo/colors/green/edge{dir = 4},/area/space)
"kV" = (/obj/structure/machinery/door_control/brbutton/alt{id = "CTF 2"; name = "Door Override"},/turf/open/floor/almayer{icon_state = "test_floor5"},/area/space)
"kZ" = (/turf/open/floor/prison/trim/red{dir = 8},/area/space)
"nC" = (/turf/open/floor/kutjevo,/area/space)
"nP" = (/turf/open/floor/kutjevo/colors/blue/edge{dir = 1},/area/space)
"oq" = (/turf/open/asphalt,/area/space)
"oP" = (/obj/structure/surface/table/reinforced/prison,/turf/open/floor/kutjevo/colors/purple/edge{dir = 8},/area/space)
"oQ" = (/obj/structure/machinery/door_control/brbutton/alt{id = "CTF 1"; name = "Door Override"},/turf/open/floor/almayer{icon_state = "test_floor5"},/area/space)
"pb" = (/turf/open/floor/kutjevo/colors/purple/edge,/area/space)
"pw" = (/turf/open/floor/kutjevo/colors/green/edge{dir = 8},/area/space)
"qn" = (/turf/open/floor/kutjevo/colors/purple/inner_corner{dir = 1},/area/space)
"qt" = (/obj/structure/bed/sofa{pixel_y = 16},/turf/open/floor/kutjevo/colors/green/edge{dir = 1},/area/space)
"qS" = (/obj/structure/machinery/door/poddoor/shutters/almayer{id = "CTF 1"},/turf/open/floor/almayer{icon_state = "test_floor4"},/area/space)
"rC" = (/obj/structure/bed,/obj/item/bedsheet/captain,/turf/open/floor/kutjevo/colors/green/edge{dir = 4},/area/space)
"rL" = (/turf/open/floor/prison/trim/red{dir = 1},/area/space)
"sn" = (/turf/open/floor/prison/trim/red{dir = 4},/area/space)
"sU" = (/obj/structure/machinery/door_control/brbutton/alt{id = "CTF 3"; name = "Door Override"},/turf/open/floor/almayer{icon_state = "test_floor5"},/area/space)
"tL" = (/turf/open/floor/almayer{icon_state = "test_floor4"},/area/space)
"tN" = (/turf/open/floor/kutjevo/colors/purple/edge{dir = 1},/area/space)
"uw" = (/turf/open/floor/kutjevo/colors/purple/edge{dir = 8},/area/space)
"vl" = (/obj/structure/bed/sofa{pixel_y = 16},/turf/open/floor/kutjevo/colors/purple/edge{dir = 1},/area/space)
"vw" = (/obj/structure/machinery/cm_vending/sorted/marine_food,/turf/open/floor/kutjevo/colors/blue/inner_corner{dir = 4},/area/space)
"wi" = (/turf/closed/wall/r_wall/bunker,/area/space)
"xu" = (/obj/structure/machinery/gear{id = null},/obj/structure/platform/strata/metal{dir = 8},/turf/open/floor/prison/trim/red,/area/space)
"xO" = (/turf/open/floor/kutjevo/colors/purple/inner_corner,/area/space)
"xS" = (/turf/open/floor/kutjevo/colors/blue/inner_corner,/area/space)
"zO" = (/turf/open/floor/kutjevo/colors/green/edge{dir = 1},/area/space)
"BE" = (/obj/structure/machinery/gear{id = null},/obj/structure/platform/strata/metal,/turf/open/floor/prison/trim/red{dir = 4},/area/space)
"BH" = (/obj/structure/bed/chair/comfy{dir = 8},/turf/open/floor/kutjevo,/area/space)
"Ds" = (/turf/open/space/basic,/area/space)
"DO" = (/obj/structure/ladder,/turf/open/floor/kutjevo/plate,/area/space)
"Fq" = (/obj/structure/machinery/gear{id = null},/obj/structure/platform/strata/metal,/turf/open/floor/prison/trim/red{dir = 8},/area/space)
"Gr" = (/obj/structure/bed,/obj/item/bedsheet/purple,/turf/open/floor/kutjevo/colors/purple/edge{dir = 4},/area/space)
"GS" = (/turf/open/floor/kutjevo/colors/green/edge,/area/space)
"Hr" = (/turf/open/floor/kutjevo/colors/purple/edge{dir = 4},/area/space)
"IZ" = (/obj/structure/machinery/cm_vending/sorted/marine_food,/turf/open/floor/kutjevo/colors/blue/edge{dir = 8},/area/space)
"Jt" = (/obj/structure/machinery/cm_vending/sorted/marine_food,/turf/open/floor/kutjevo/colors/green/inner_corner{dir = 4},/area/space)
"JL" = (/turf/open/floor/kutjevo/colors/red/edge{dir = 10},/area/space)
"MB" = (/obj/structure/bed/sofa{pixel_y = 16},/turf/open/floor/kutjevo/colors/blue/edge{dir = 1},/area/space)
"MM" = (/obj/structure/machinery/door/poddoor/almayer/locked{name = "Tunnel Checkpoint"},/turf/open/floor/almayer{icon_state = "test_floor4"},/area/space)
"Oz" = (/obj/structure/platform/strata/metal,/obj/structure/bed/chair/dropship/passenger{dir = 1; pixel_y = 6},/turf/open/floor/engine,/area/space)
"Pf" = (/turf/open/floor/kutjevo/colors/blue/edge,/area/space)
"Py" = (/obj/structure/machinery/gear{id = null},/obj/structure/platform/strata/metal{dir = 1; pixel_y = 9},/turf/open/floor/prison/trim/red{dir = 8},/area/space)
"Qb" = (/obj/structure/surface/table/reinforced/prison,/turf/open/floor/kutjevo/colors/green/edge{dir = 8},/area/space)
"Qz" = (/obj/structure/machinery/cm_vending/sorted/cargo_guns/squad_prep{density = 0; hackable = 0; hacked = 1; pixel_y = -30; req_one_access = null},/turf/open/floor/kutjevo/colors/red/edge{dir = 1},/area/space)
"Rx" = (/obj/structure/machinery/cm_vending/sorted/marine_food,/turf/open/floor/kutjevo/colors/green/edge{dir = 8},/area/space)
"RR" = (/obj/structure/machinery/cm_vending/sorted/cargo_ammo{density = 0; hacked = 1; pixel_y = -30; req_access = null; req_one_access = null},/turf/open/floor/kutjevo/colors/red/edge{dir = 5},/area/space)
"Sc" = (/turf/open/floor/kutjevo/colors/red/edge{dir = 6},/area/space)
"Sd" = (/obj/structure/machinery/door/poddoor/shutters/almayer{id = "CTF 2"},/turf/open/floor/almayer{icon_state = "test_floor4"},/area/space)
"Tv" = (/turf/open/floor/kutjevo/colors/blue/edge{dir = 8},/area/space)
"Ty" = (/obj/structure/machinery/gear{id = null},/obj/structure/platform/strata/metal{dir = 4},/turf/open/floor/prison/trim/red{dir = 1},/area/space)
"TH" = (/turf/open/floor/kutjevo/colors/blue/inner_corner{dir = 8},/area/space)
"Uy" = (/obj/structure/machinery/door/airlock/multi_tile/almayer/almayer,/turf/open/floor/almayer{icon_state = "test_floor4"},/area/space)
"Vo" = (/turf/open/floor/kutjevo/colors/red/tile,/area/space)
"Vx" = (/obj/structure/machinery/cm_vending/sorted/marine_food,/turf/open/floor/kutjevo/colors/purple/inner_corner{dir = 4},/area/space)
"Vz" = (/turf/open/floor/kutjevo/colors/blue/inner_corner{dir = 1},/area/space)
"VC" = (/turf/open/floor/kutjevo/colors/green/inner_corner,/area/space)
"Wa" = (/turf/open/floor/kutjevo/colors/green/inner_corner{dir = 8},/area/space)
"Wn" = (/obj/structure/machinery/cm_vending/sorted/marine_food,/turf/open/floor/kutjevo/colors/purple/edge{dir = 8},/area/space)
"WC" = (/obj/structure/machinery/gear{id = null},/obj/structure/platform/strata/metal{dir = 1; pixel_y = 9},/turf/open/floor/prison/trim/red{dir = 4},/area/space)
"WK" = (/obj/structure/machinery/door/poddoor/shutters/almayer{id = "CTF 3"},/turf/open/floor/almayer{icon_state = "test_floor4"},/area/space)
"Xl" = (/turf/open/floor/kutjevo/colors/purple/inner_corner{dir = 8},/area/space)
"Yn" = (/turf/open/floor/kutjevo/colors/red/edge{dir = 8},/area/space)
"ZH" = (/obj/structure/machinery/door/poddoor/almayer/locked{dir = 4; name = "Tunnel Checkpoint"},/turf/open/floor/almayer{icon_state = "test_floor4"},/area/space)
"ZK" = (/obj/structure/machinery/gear{id = null},/obj/structure/platform/strata/metal{dir = 4},/turf/open/floor/prison/trim/red,/area/space)
"ZW" = (/obj/structure/surface/table/reinforced/prison,/turf/open/floor/kutjevo/colors/blue/edge{dir = 8},/area/space)

(1,1,1) = {"
bjbjbjbjbjbjbjbjbjbjbjbjbjbjbjbjbjbjbjbjbjbjbjbjbjbjbjbjbjbjbjbjbjbjbjbjbjbjbjbjbjbjbjbjbjbjbjbjbjbjbjbjbjbjbjbjbjbjbjbjbjbjbjbjbjbjbjbjbjbjbjbjbjbjbjbjbjbjbjbjbjbjbjbjbjbjbjbjbjbjbjbjbjbjbjbjbjbjbjbj
bjjgjgjgjgjgjgjgbjbjjgjgjgjgjgjgjgbjbjjgjgjgjgjgjgjgbjbjbjbjbjbjbjbjbjbjbjbjbjbjbjbjbjbjbjbjbjbjbjbjbjbjbjbjbjbjbjbjbjbjbjbjbjbjbjbjbjbjbjbjbjbjbjbjbjbjbjbjbjbjbjbjbjbjbjbjbjbjbjbjbjbjbjbjbjbjbjbjbjbj
bjjgDODOjgDODOjgbjbjjgDODOjgDODOjgbjbjjgDODOjgDODOjgbjbjbjbjbjbjbjbjbjbjbjbjbjbjbjbjbjbjbjbjbjbjbjbjbjbjbjbjbjbjbjbjbjbjbjbjbjbjbjbjbjbjbjbjbjbjbjbjbjbjbjbjbjbjbjbjbjbjbjbjbjbjbjbjbjbjbjbjbjbjbjbjbjbj
bjjgUytLjgUytLjgbjbjjgUytLjgUytLjgbjbjjgUytLjgUytLjgbjbjbjbjbjbjbjbjbjbjbjbjbjbjbjbjbjbjbjbjbjbjbjbjbjbjbjbjbjbjbjbjbjbjbjbjbjbjbjbjbjbjbjbjbjbjbjbjbjbjbjbjbjbjbjbjbjbjbjbjbjbjbjbjbjbjbjbjbjbjbjbjbjbj
bjjgxSnPMBnPVzjgbjbjjgxOtNvltNqnjgbjbjjgVCzOqtzOgljgbjbjbjbjbjbjbjbjbjbjbjbjbjbjbjbjbjbjbjbjbjbjbjbjbjbjbjbjbjbjbjbjbjbjbjbjbjbjbjbjbjbjbjbjbjbjbjbjbjbjbjbjbjbjbjbjbjbjbjbjbjbjbjbjbjbjbjbjbjbjbjbjbjbj
bjjgTvnCnCnCjejgbjbjjguwnCnCnCGrjgbjbjjgpwnCnCnCrCjgbjbjbjbjbjbjbjbjbjbjbjbjbjbjbjbjbjbjbjbjbjbjbjbjbjbjbjbjbjbjbjbjbjbjbjbjbjbjbjbjbjbjbjbjbjbjbjbjbjbjbjbjbjbjbjbjbjbjbjbjbjbjbjbjbjbjbjbjbjbjbjbjbjbj
bjjgZWBHnCnChbjgbjbjjgoPBHnCnCHrjgbjbjjgQbBHnCnCkTjgbjbjbjbjbjbjbjbjbjbjbjbjbjbjbjbjbjbjbjbjbjbjbjbjbjbjbjbjbjbjbjbjbjbjbjbjbjbjbjbjbjbjbjbjbjbjbjbjbjbjbjbjbjbjbjbjbjbjbjbjbjbjbjbjbjbjbjbjbjbjbjbjbjbj
bjjgZWnCnCnCjejgbjbjjgoPnCnCnCGrjgbjbjjgQbnCnCnCrCjgbjbjbjbjbjbjbjbjbjbjbjbjbjbjbjbjbjbjbjbjbjbjbjbjbjbjbjbjbjbjbjbjbjbjbjbjbjbjbjbjbjbjbjbjbjbjbjbjbjbjbjbjbjbjbjbjbjbjbjbjbjbjbjbjbjbjbjbjbjbjbjbjbjbj
bjjgZWBHnCnChbjgbjbjjgoPBHnCnCHrjgbjbjjgQbBHnCnCkTjgbjbjbjbjbjbjbjbjbjbjbjbjbjbjbjbjbjbjbjbjbjbjbjbjbjbjbjbjbjbjbjbjbjbjbjbjbjbjbjbjbjbjbjbjbjbjbjbjbjbjbjbjbjbjbjbjbjbjbjbjbjbjbjbjbjbjbjbjbjbjbjbjbjbj
bjjgIZnCnCnCjejgbjbjjgWnnCnCnCGrjgbjbjjgRxnCnCnCrCjgbjbjbjbjbjbjbjbjbjbjbjbjbjbjbjbjbjbjbjbjbjbjbjbjbjbjbjbjbjbjbjbjbjbjbjbjbjbjbjbjbjbjbjbjbjbjbjbjbjbjbjbjbjbjbjbjbjbjbjbjbjbjbjbjbjbjbjbjbjbjbjbjbjbj
bjjgvwPfPfPfTHjgbjbjjgVxpbpbpbXljgbjbjjgJtGSGSGSWajgbjbjbjbjbjbjbjbjbjbjbjbjbjbjbjbjbjbjbjbjbjbjbjbjbjbjbjbjbjbjbjbjbjbjbjbjbjbjbjbjbjbjbjbjbjbjbjbjbjbjbjbjbjbjbjbjbjbjbjbjbjbjbjbjbjbjbjbjbjbjbjbjbjbj
bjjgjgjgqSqSqSjgbjbjjgjgjgSdSdSdjgbjbjjgjgjgWKWKWKjgbjbjbjbjbjbjbjjgMMMMMMMMjgjgjgjgjgjgjgjgjgjgjgjgjgjgjgjgjgjgjgjgjgjgjgjgjgjgjgjgjgjgjgjgjgjgjgjgjgjgjgjgjgjgjgjgjgjgjgbjbjbjbjbjbjbjbjbjbjbjbjbjbjbj
bjjgoQjgSchFJLjgbjbjjgkVjgSchFJLjgbjbjjgsUjgSchFJLjgbjbjbjbjbjbjbjjgahrLrLTyjgDsDsDsDsDsDsDsDsDsDsDsDsDsDsDsDsDsDsDsDsDsDsDswiDsDsDsDsDsDsDsDswiDsDsDsDsDswiDsDsDsDsDsDsjgbjbjbjbjbjbjbjbjbjbjbjbjbjbjbj
bjjgjgjgcWVoYnjgbjbjjgjgjgcWVoYnjgbjbjjgjgjgcWVoYnjgbjbjbjbjbjbjbjjgfsdCdCfmjgDsDsDsDsDsDsDsDsDsDsDsDsDsDsDsDsDsDsDsDsDsDsDswiDsDsDsDsDsDsDsDswiDsDsDsDsDswiDsDsDsDsDsDsjgbjbjbjbjbjbjbjbjbjbjbjbjbjbjbj
bjbjbjjgRRQzjKjgbjbjbjbjjgRRQzjKjgbjbjbjbjjgRRQzjKjgbjbjbjbjbjbjbjjgfsdCdCfmjgDsDsDsDsDsDsDsDsDsDsDsDsDsDsDsDsDsDsDsDsDsDsDswiDsDsDsDsDsDsDsDswiDsDsDsDsDswiDsDsDsDsDsDsjgjgjgjgjgjgjgjgjgbjbjbjbjbjbjbj
bjbjbjjgjgjgjgjgbjbjbjbjjgjgjgjgjgbjbjbjbjjgjgjgjgjgbjbjbjbjbjbjbjjgfsdCdCfmjgDsDsDsDsDsDsDsDsDsDsDsDsDsDsDsDsDsDsDsDsDsDsDswiDsDsDsDsDsDsDsDswiDsDsDsDsDswiDsDsDsDsDsDswiDsDsDsDsDsDsDsjgbjbjbjbjbjbjbj
bjbjbjbjbjbjbjbjbjbjbjbjbjbjbjbjbjbjbjbjbjbjbjbjbjbjbjbjbjbjbjbjbjjgxubSbSZKjgDsDsDsDsDsDsDsDsDsDsDsDsDsDsDsDsDsDsDsDsDsDsDswiDsDsDsDsDsDsDsDswiDsDsDsDsDswiDsDsDsDsDsDswiDsDsDsDsDsDsDsjgbjbjbjbjbjbjbj
bjbjbjbjbjbjbjbjbjbjbjbjbjbjbjbjbjbjbjbjbjbjbjbjbjbjbjbjbjbjbjbjbjjgMMMMMMMMjgDsDsDsDsDsDsDsDsDsDsDsDsDsDsDsDsDsDsDswiwiwiwiwiwiwiwiwiwiwiwiwiwiDsDsDsDsDswiDsDsDsDsDsDswiDsDsDsDsDsDsDsjgbjbjbjbjbjbjbj
bjbjbjbjbjbjbjbjbjbjbjbjbjbjbjbjbjbjbjbjbjbjbjbjbjbjbjbjbjbjbjbjbjjgoqoqoqoqjgDsDsDsDsDsDsDsDsDsDsDsDsDsDsDsDsDsDsDswioqoqoqoqoqoqoqoqoqoqoqoqwiDsDsDsDsDswiDsDsDsDsDsDswiDsDsDsDsDsDsDsjgbjbjbjbjbjbjbj
bjbjbjbjbjbjbjbjbjbjbjbjbjbjbjbjbjbjbjbjbjbjbjbjbjbjbjbjbjbjbjbjbjjgoqoqoqoqjgDsDsDsDsDsDsDsDsDsDsDsDsDsDsDsDsDsDsDswioqoqoqoqoqoqoqoqoqoqoqoqwiDsDsDsDsDswiDsDsDsDsDsDswiDsDsDsDsDsDsDsjgbjbjbjbjbjbjbj
bjbjbjbjbjbjbjbjbjbjbjbjbjbjjgjgjgjgjgjgjgjgjgjgjgjgjgjgjgjgjgjgjgjgoqoqoqoqjgDsDsDsDsDsDsDsDsDsDsDsDsDsDsDsDsDsDsDswioqoqjgjgjgjgjgjgjgjgoqoqwiwiwiwiwiwiwiwiwiwiwiwiwiwiwiwiwiwiDsDsDsjgbjbjbjbjbjbjbj
bjbjbjbjbjbjbjbjbjbjbjbjbjbjjgoqoqoqoqoqoqoqoqoqoqoqoqoqoqoqoqoqoqoqoqoqoqoqjgDsDsDsDsDsDsDsDsDsDsDsDsDsDsDsDsDsDsDswioqoqjgbjbjbjbjbjbjjgoqoqoqoqoqoqoqoqoqoqoqoqoqoqoqoqoqoqoqwiDsDsDsjgbjbjbjbjbjbjbj
bjbjbjbjbjbjbjbjbjbjbjbjbjbjjgoqoqoqoqoqoqoqoqoqoqoqoqoqoqoqoqoqoqoqoqoqoqoqjgDsDsDsDsDsDsDsDsDsDsDsDsDsDsDsDsDsDsDswioqoqjgbjbjbjbjbjbjjgoqoqoqoqoqoqoqoqoqoqoqoqoqoqoqoqoqoqoqwiwiwiwijgbjbjbjbjbjbjbj
bjbjbjbjbjbjbjbjbjbjbjbjbjbjjgoqoqwiwiwiwiwiwiwiwiwiwiwiwiwiwiwiwiwioqoqoqoqjgDsDsDsDsDsDsDsDsDsDsDsDsDsDsDsDsDsDsDswioqoqjgbjbjbjbjbjbjjgoqoqgYgYgYgYgYgYgYgYgYgYgYgYgYgYgYoqoqwiDsDsDsjgbjbjbjbjbjbjbj
bjbjbjbjbjbjbjbjbjbjbjbjbjbjjgoqoqwiDsDsDswiDsDsDswiDsDsDswiDsDsDswioqoqoqoqjgDsDsDsDsDsDsDsDsDsDsDsDsDsDsDsDsDsDsDswioqoqjgbjbjbjbjbjbjjgoqoqgYgxgxgxgxgxgxgxgxgxgxgxgxgxgYoqoqwiDsDsDsjgbjbjbjbjbjbjbj
bjbjbjbjbjbjbjbjbjbjbjbjbjbjjgoqoqwiDsDsDswiDsDsDswiDsDsDswiDsDsDswioqoqoqoqwiwiwiwiwiwiwiwiwiwiwiwiwiwiwiwiwiwiwiwiwioqoqjgbjbjbjbjbjbjjgoqoqgYgxgxgxgxgxgxgxgxgxgxgxgxgxgYoqoqwiDsDsDsjgbjbjbjbjbjbjbj
bjbjbjbjbjbjbjbjbjbjbjbjbjbjjgoqoqwiDsDsDswiDsDsDswiDsDsDswiDsDsDswioqoqoqoqgYgYgYgYgYgYgYgYgYgYgYgYgYgYgYgYgYgYgYgYgYoqoqjgbjbjbjbjbjbjjgoqoqgYgxgxgxgxgxgxgxgxgxgxgxgxgxgYoqoqwiwiwiwijgbjbjbjbjbjbjbj
bjbjbjbjbjbjbjbjbjbjbjbjbjbjjgoqoqwiwiwiwiwiwiwiwiwiwiwiwiwiwiwiwiwioqoqoqoqgYgxgxgxgxgxgxgxgxgxgxgxgxgxgxgxgxgxgxgxgYoqoqjgbjbjbjbjbjbjjgoqoqgYgxgxgxgxgxgxgxgxgxgxgxgxgxgYoqoqwiDsDsDsjgbjbjbjbjbjbjbj
bjbjbjbjbjbjbjbjbjbjbjbjbjbjjgoqoqoqoqoqoqoqoqoqoqoqoqoqwiDsDsDsDswioqoqoqoqgYgYgYgYgYgYgYgYgYgYgYgYgYgYgYgYgYgYgYgYgYoqoqjgbjbjbjbjbjbjjgoqoqgYgxgxgxgxgxgxgxgxgxgxgxgxgxgYoqoqwiDsDsDsjgbjbjbjbjbjbjbj
bjbjbjbjbjbjbjbjbjbjbjbjbjbjjgoqoqoqoqoqoqoqoqoqoqoqoqoqwiDsDsDsDswioqoqoqoqoqoqoqoqoqoqoqoqoqoqoqoqoqoqoqoqoqoqoqoqoqoqoqjgjgjgjgjgjgjgjgoqoqgYgxgxgxgxgxgxgxgxgxgxgxgxgxgYoqoqwiDsDsDsjgbjbjbjbjbjbjbj
bjbjbjbjbjbjbjbjbjbjbjbjbjbjjgwiwiwiwiwiwiwiwiwiwiwioqoqwiDsDsDsDswioqoqoqoqoqoqoqoqoqoqoqoqoqoqoqoqoqoqoqoqoqoqoqoqoqoqoqoqoqoqoqoqoqoqoqoqoqgYgxgxgxgxgxgxgxgxgxgxgxgxgxgYoqoqwiwiwiwijgbjbjbjbjbjbjbj
bjbjbjbjbjbjbjbjbjbjbjbjbjbjjgDsDsDsDsDsDsDsDsDsDswioqoqwiDsDsDsDswioqoqoqoqoqoqoqoqoqoqoqoqoqoqoqoqoqoqoqoqoqoqoqoqoqoqoqoqoqoqoqoqoqoqoqoqoqgYgYgYgYgYgYgYgYgYgxgxgxgxgxgYoqoqwiDsDsDsjgbjbjbjbjbjbjbj
bjbjbjbjbjbjbjbjbjbjbjbjbjbjjgDsDsDsDsDsDsDsDsDsDswioqoqwiDsDsDsDswioqoqoqoqoqoqoqoqoqoqoqoqoqoqoqoqoqoqoqoqoqoqoqoqoqoqoqoqoqoqoqoqoqoqoqoqoqwiwiwiwiwiwiwiwigYgxgxgxgxgxgYoqoqwiDsDsDsjgbjbjbjbjbjbjbj
bjbjbjbjbjbjbjbjbjbjbjbjbjbjjgDsDsDsDsDsDsDsDsDsDswioqoqwiDsDsDsDswioqoqoqoqgYgYgYgYgYgYgYgYgYgYgYgYgYgYgYgYgYgYgYoqoqoqoqoqoqoqoqoqoqoqoqoqoqwiDsDsDsDsDsDswigYgxgxgxgxgxgYoqoqwiDsDsDsjgbjbjbjbjbjbjbj
bjbjbjbjbjbjbjbjbjbjbjbjbjbjjgDsDsDsDsDsDsDsDsDsDswioqoqwiwiwiwiwiwioqoqoqoqgYgxgxgxgxgxgxgxgxgxgxgxgxgxgxgxgxgxgYwiwiwiwiwiwiwiwiwiwioqoqoqoqwiDsDsDsDsDsDswigYgxgxgxgxgxgYoqoqjgjgjgjgjgbjbjbjbjbjbjbj
bjbjbjbjbjbjbjbjbjbjbjjgjgjgjgwiwiwiwiDsDsDsDsDsDswioqoqwiDsDsDsDswioqoqoqoqgYgxgxgxgxgxgxgxgxgxgxgxgxgxgxgxgxgxgYwiDsDsDsDsDsDsDsDswioqoqoqoqwiDsDsDsDsDsDswigYgxgxgxgxgxgYoqoqjgbjbjbjbjbjbjbjbjbjbjbj
bjbjbjbjbjbjbjbjbjbjbjjgDsDsDsDsDsDswiDsDsDsDsDsDswioqoqwiDsDsDsDswioqoqoqoqgYgxgxgxgxgxgxgxgxgxgxgxgxgxgxgxgxgxgYwiDsDsDsDsDsDsDsDswioqoqoqoqwiDsDsDsDsDsDswigYgxgxgxgxgxgYoqoqjgbjbjbjbjbjbjbjbjbjbjbj
bjbjbjbjbjbjbjbjbjbjbjjgDsDsDsDsDsDswiDsDsDsDsDsDswioqoqwiDsDsDsDswioqoqoqoqgYgxgxgxgxgxgxgxgxgxgxgxgxgxgxgxgxgxgYwiDsDsDsDsDsDsDsDswioqoqoqoqwiDsDsDsDsDsDswigYgxgxgxgxgxgYoqoqjgbjbjbjbjbjbjbjbjbjbjbj
bjbjbjbjbjbjbjbjbjbjbjjgDsDsDsDsDsDswiDsDsDsDsDsDswioqoqwiDsDsDsDswioqoqoqoqgYgxgxgxgxgxgxgxgxgxgxgxgxgxgxgxgxgxgYwiDsDsDsDsDsDsDsDswioqoqoqoqwiDsDsDsDsDsDswigYgxgxgxgxgxgYoqoqjgbjbjbjbjbjbjbjbjbjbjbj
bjbjbjbjbjbjbjbjbjbjbjjgDsDsDsDsDsDswiDsDsDsDsDsDswioqoqwiDsDsDsDswioqoqoqoqgYgxgxgxgxgxgxgxgxgxgxgxgxgxgxgxgxgxgYwiDsDsDsDsDsDsDsDswioqoqoqoqwiDsDsDsDsDsDswigYgxgxgxgxgxgYoqoqjgbjbjbjbjbjbjbjbjbjbjbj
bjbjbjbjbjbjbjbjbjbjbjjgDsDsDsDsDsDswiDsDsDsDsDsDswioqoqwiDsDsDsDswioqoqoqoqgYgxgxgxgxgxgxgxgxgxgxgxgxgxgxgxgxgxgYwiDsDsDsDsDsDsDsDswioqoqoqoqwiwiwiwiwiwiwiwigYgYgYgYgYgYgYoqoqjgbjbjbjbjbjbjbjbjbjbjbj
bjbjbjbjbjbjbjbjbjbjbjjgDsDsDsDsDsDswiDsDsDsDsDsDswioqoqwiDsDsDsDswioqoqoqoqgYgxgxgxgxgxgxgxgxgxgxgxgxgxgxgxgxgxgYwiDsDsDsDsDsDsDsDswioqoqoqoqoqoqoqoqoqoqoqoqoqoqoqoqoqoqoqoqoqjgbjbjbjbjbjbjbjbjbjbjbj
bjbjbjbjbjbjbjbjbjbjbjjgDsDsDsDsDsDswiwiwiwiwiwiwiwioqoqwiwiwiwiwiwioqoqoqoqgYgYgYgYgYgYgYgYgYgYgYgYgYgYgYgYgYgYgYwiwiwiwiwiwiwiwiwiwioqoqoqoqoqoqoqoqoqoqoqoqoqoqoqoqoqoqoqoqoqjgbjbjbjbjbjbjbjbjbjbjbj
bjbjbjbjbjbjbjbjbjbjjgjgwiwiwiwiwiwiwioqoqoqoqoqoqoqoqoqoqoqoqoqoqoqoqoqoqoqoqoqoqoqoqoqoqoqoqoqoqoqoqoqoqoqoqoqoqoqoqoqoqoqoqoqoqoqoqoqoqoqoqgYgYgYgYwiwiwiwiwiwiwiwiwiwiwioqoqjgbjbjbjbjbjbjbjbjbjbjbj
bjbjbjbjbjbjbjbjbjbjjgoqoqoqoqoqoqoqoqoqoqoqoqoqoqoqoqoqoqoqoqoqoqoqoqoqoqoqoqoqoqoqoqoqoqoqoqoqoqoqoqoqoqoqoqoqoqoqoqoqoqoqoqoqoqoqoqoqoqoqoqgYgxgxgYwiDsDsDsDsDsDsDsDsDswioqoqjgjgjgjgjgbjbjbjbjbjbjbj
bjbjbjbjbjbjbjbjbjbjjgoqoqoqoqoqoqoqoqoqoqoqoqoqoqoqoqoqoqoqoqoqoqoqoqoqoqoqoqoqoqoqoqoqoqoqoqoqoqoqoqoqoqoqoqoqoqoqoqoqoqoqoqoqoqoqoqoqoqoqoqgYgxgxgYwiDsDsDsDsDsDsDsDsDswioqoqoqoqoqoqjgbjbjbjbjbjbjbj
bjbjbjbjbjbjbjbjbjbjjgoqoqwiwiwiwiwiwioqoqoqoqoqoqoqoqoqoqoqoqoqoqoqoqoqoqoqoqoqoqoqoqoqoqoqoqoqoqoqoqoqoqoqoqoqoqoqoqoqoqoqoqoqoqoqoqoqoqoqoqgYgxgxgYwiDsDsDsDsDsDsDsDsDswioqoqoqoqoqoqjgbjbjbjbjbjbjbj
bjbjbjbjbjbjbjbjbjbjjgoqoqwiDsDsDsDswioqoqoqoqgYgYgYgYgYgYgYgYgYgYgYgYgYgYwiwiwiwiwiwiwioqoqwiwiwiwiwioqoqwiwiwiwiwiwiwiwiwiwiwiwiwiwioqoqoqoqgYgxgxgYwiDsDsDsDsDsDsDsDsDswiwiwiwiwioqoqjgbjbjbjbjbjbjbj
bjbjbjbjbjbjbjbjbjbjjgoqoqwiDsDsDsDswioqoqoqoqgYgxgxgxgxgxgxgxgxgxgxgxgxgYwiDsDsDsDsDswioqoqwiDsDsDswioqoqwiDsDsDsDsDsDsDsDsDsDsDsDswioqoqoqoqgYgxgxgYwiDsDsDsDsDsDsDsDsDsDsDsDsDswioqoqjgbjbjbjbjbjbjbj
bjbjbjbjbjbjbjbjbjbjjgoqoqwiDsDsDsDswioqoqoqoqgYgxgxgxgxgxgxgxgxgxgxgxgxgYwiDsDsDsDsDswioqoqwiDsDsDswioqoqwiDsDsDsDsDsDsDsDsDsDsDsDswioqoqoqoqgYgxgxgYwiDsDsDsDsDsDsDsDsDsDsDsDsDswioqoqjgbjbjbjbjbjbjbj
bjbjbjbjbjbjbjbjbjbjjgoqoqwiDsDsDsDswioqoqoqoqgYgxgxgxgxgxgxgxgxgxgxgxgxgYwiDsDsDsDsDswioqoqwiDsDsDswioqoqwiDsDsDsDsDsDsDsDsDsDsDsDswioqoqoqoqgYgxgxgYwiDsDsDsDsDsDsDsDsDsDsDsDsDswioqoqjgbjbjbjbjbjbjbj
bjbjbjbjbjbjbjbjbjbjjgoqoqwiDsDsDsDswioqoqoqoqgYgxgxgxgxgxgxgxgxgxgxgxgxgYwiDsDsDsDsDswioqoqwiDsDsDswioqoqwiwiwiwiDsDsDsDsDsDsDsDsDswioqoqoqoqgYgxgxgYwiDsDsDsDsDsDsDsDsDsDsDsDsDswioqoqjgbjbjbjbjbjbjbj
bjbjbjbjbjbjbjbjbjbjjgoqoqwiDsDsDsDswioqoqoqoqgYgxgxgxgxgxgxgxgxgxgYgYgYgYwiDsDsDsDsDswioqoqwiDsDsDswioqoqoqoqoqwiDsDsDsDsDsDsDsDsDswioqoqoqoqgYgxgxgYwiDsDsDsDsDsDsDsDsDsDsDsDsDswioqoqjgbjbjbjbjbjbjbj
bjbjbjbjbjbjbjbjbjbjjgoqoqwiDsDsDsDswioqoqoqoqgYgYgYgYgYgYgYgYgYgYgYwiwiwiwiwiwiwiwiwiwioqoqwiwiwiwiwioqoqoqoqoqwiDsDsDsDsDsDsDsDsDswioqoqoqoqgYgxgxgYwiDsDsDsDsDsDsDsDsDsDsDsDsDswioqoqjgbjbjbjbjbjbjbj
bjbjbjbjbjbjbjbjbjbjjgoqoqwiwiwiwiwiwioqoqoqoqwiwiwiwiwiwiwiwiwiwiwiwiDsDsDsDsDsDsDsDswioqoqgYgYgYgYgYgYgYgYoqoqwiDsDsDsDsDsDsDsDsDswioqoqoqoqgYgxgxgYwiDsDsDsDsDsDsDsDsDsDsDsDsDswioqoqjgbjbjbjbjbjbjbj
bjbjbjbjbjbjbjbjbjbjjgoqoqoqoqoqoqoqoqoqoqoqoqwiDsDsDsDsDsDsDsDsDsDswiDsDsDsDsDsDsDsDswioqoqgYDsDsDsDsDsDsgYoqoqwiDsDsDsDsDsDsDsDsDswioqoqoqoqgYgxgxgYwiDsDsDsDsDsDsDsDsDsDsDsDsDswioqoqjgbjbjbjbjbjbjbj
bjbjbjbjbjbjbjbjbjbjjgoqoqoqoqoqoqoqoqoqoqoqoqwiDsDsDsDsDsDsDsDsDsDswiDsDsDsDsDsDsDsDswioqoqgYDsDsDsDsDsDsgYoqoqwiDsDsDsDsDsDsDsDsDswioqoqoqoqgYgxgxgYwiDsDsDsDsDsDsDsDsDsDsDsDsDswioqoqjgbjbjbjbjbjbjbj
bjbjbjbjbjbjbjbjbjjgjgoqoqwiwiwiwiwiwioqoqoqoqwiDsDsDsDsDsDsDsDsDsDswiDsDsDsDsDsDsDsDswioqoqgYDsDsDsDsDsDsgYoqoqwiDsDsDsDsDsDsDsDsDswioqoqoqoqgYgxgxgYwiDsDsDsDsDsDsDsDsDsDsDsDsDswioqoqjgbjbjbjbjbjbjbj
bjbjbjbjbjbjbjbjbjjgoqoqoqwiDsDsDsDswioqoqoqoqwiDsDsDsDsDsDsDsDsDsDswiDsDsDsDsDsDsDsDswioqoqgYDsDsDsDsDsDsgYoqoqwiDsDsDsDsDsDsDsDsDswioqoqoqoqgYgxgxgYwiDsDsDsDsDsDsDsDsDswiwiwiwiwioqoqjgbjbjbjbjbjbjbj
bjbjbjbjbjbjbjbjbjjgoqoqwiwiDsDsDsDswioqoqoqoqwiDsDsDsDsDsDsDsDsDsDswiDsDsDsDsDsDsDsDswioqoqgYDsDsDsDsDsDsgYoqoqwiwiwiwiwiwiwiwiwiwiwioqoqoqoqgYgxgxgYwiDsDsDsDsDsDsDsDsDswioqoqoqoqoqoqjgbjbjbjbjbjbjbj
bjbjbjbjbjbjbjbjbjjgoqoqwiDsDsDsDsDswioqoqoqoqwiDsDsDsDsDsDsDsDsDsDswiDsDsDsDsDsDsDsDswioqoqgYDsDsDsDsDsDsgYoqoqoqoqoqoqoqoqoqoqoqoqoqoqoqoqoqgYgYgYgYwiwiwiwiwiwiwiwiwiwiwioqoqoqoqoqoqjgbjbjbjbjbjbjbj
bjbjbjbjbjbjbjbjbjjgoqoqwiDsDsDsDsDswioqoqoqoqwiDsDsDsDsDsDsDsDsDsDswiDsDsDsDsDsDsDsDswioqoqgYgYgYgYgYgYgYgYoqoqoqoqoqoqoqoqoqoqoqoqoqoqoqoqoqoqoqoqoqoqoqoqoqoqoqoqoqoqoqoqoqoqjgjgjgjgjgbjbjbjbjbjbjbj
bjbjbjbjbjbjbjbjbjjgoqoqwiDsDsDsDsDswioqoqoqoqwiwiwiwiwiwiwiwiwiwiwiwiwiwiwiwiwiwiwiwiwioqoqoqoqoqoqoqoqoqoqoqoqwiwiwiwiwiwiwiwiwiwiwioqoqoqoqoqoqoqoqoqoqoqoqoqoqoqoqoqoqoqoqoqjgbjbjbjbjbjbjbjbjbjbjbj
bjbjbjbjbjbjbjbjbjjgoqoqwiDsDsDsDsDswioqoqoqoqoqoqoqoqoqoqoqoqoqoqoqoqoqoqoqoqoqoqoqoqoqoqoqoqoqoqoqoqoqoqoqoqoqwiDsDsDsDsDsDsDsDsDswioqoqoqoqwiwiwiwiwiwiwioqoqwiwiwiwiwiwiwiwijgbjbjbjbjbjbjbjbjbjbjbj
bjbjbjbjbjbjbjbjbjjgoqoqwiDsDsDsDsDswioqoqoqoqoqoqoqoqoqoqoqoqoqoqoqoqoqoqoqoqoqoqoqoqoqoqoqwiwiwiwiwiwiwiwiwiwiwiDsDsDsDsDsDsDsDsDswioqoqoqoqwiDsDsDsDsDswioqoqwiDsDsDsDsDsDsDsjgbjbjbjbjbjbjbjbjbjbjbj
bjbjbjbjbjbjbjbjbjjgoqoqwiDsDsDsDsDswioqoqoqoqwiwiwiwiwiwiwiwiwiwiwiwiwiwiwiwiwiwiwiwiwiwiwiwiDsDsDsDsDsDsDsDsDswiDsDsDsDsDsDsDsDsDswioqoqoqoqwiDsDsDsDsDswioqoqwiDsDsDsDsDsDsDsjgbjbjbjbjbjbjbjbjbjbjbj
bjbjbjbjbjbjbjbjbjjgoqoqwiDsDsDsDsDswioqoqoqoqwiDsDsDsDsDsDsDsDsDsDswiDsDsDsDsDswiDsDsDsDsDswiDsDsDsDsDsDsDsDsDswiDsDsDsDsDsDsDsDsDswioqoqoqoqwiDsDsDsDsDswioqoqwiDsDsDsDsDsDsDsjgbjbjbjbjbjbjbjbjbjbjbj
bjbjbjbjbjbjbjbjbjjgoqoqwiwiwiwiwiwiwioqoqoqoqwiDsDsDsDsDsDsDsDsDsDswiDsDsDsDsDswiDsDsDsDsDswiDsDsDsDsDsDsDsDsDswiDsDsDsDsDsDsDsDsDswioqoqoqoqwiDsDsDsDsDswioqoqwiDsDsDsDsDsDsDsjgbjbjbjbjbjbjbjbjbjbjbj
bjbjbjbjbjbjbjbjbjjgoqoqoqoqoqoqoqoqoqoqoqoqoqwiDsDsDsDsDsDsDsDsDsDswiDsDsDsDsDswiDsDsDsDsDswiDsDsDsDsDsDsDsDsDswiwiwiwiwiwiwiwiwiwiwioqoqoqoqwiDsDsDsDsDswioqoqwiwiwiwiwiwiwiwijgbjbjbjbjbjbjbjbjbjbjbj
bjbjbjbjbjbjbjbjbjjgoqoqoqoqoqoqoqoqoqoqoqoqoqwiDsDsDsDsDsDsDsDsDsDswiDsDsDsDsDswiDsDsDsDsDswiDsDsDsDsDsDsDsDsDswiDsDsDsDsDsDsDsDsDswioqoqoqoqwiDsDsDsDsDswioqoqoqoqwiDsDsDsDsDsjgbjbjbjbjbjbjbjbjbjbjbj
bjbjbjbjbjbjbjbjbjjgoqoqoqoqoqoqoqoqoqoqoqoqoqwiDsDsDsDsDsDsDsDsDsDswiDsDsDsDsDswiDsDsDsDsDswiDsDsDsDsDsDsDsDsDswiDsDsDsDsDsDsDsDsDswioqoqoqoqwiDsDsDsDsDswioqoqoqoqwiDsDsDsDsDsjgbjbjbjbjbjbjbjbjbjbjbj
bjbjbjbjbjbjbjbjbjjgoqoqoqoqoqoqoqoqoqoqoqoqoqwiDsDsDsDsDsDsDsDsDsDswiDsDsDsDsDswiwiwiwiwiwiwiwiwiwiwiwiwiwiwiwiwiDsDsDsDsDsDsDsDsDswioqoqoqoqwiwiwiwiwiwiwiwiwioqoqwiDsDsDsDsDsjgbjbjbjbjbjbjbjbjbjbjbj
bjbjbjbjbjbjbjbjbjjgoqoqwiwiwiwiwiwiwioqoqoqoqwiDsDsDsDsDsDsDsDsDsDswiDsDsDsDsDswigYgYgYgYgYgYgYgYgYgYgYgYgYgYgYwiDsDsDsDsDsDsDsDsDswioqoqoqoqwiDsDsDsDsDsDsDswioqoqwiDsDsDsDsDsjgbjbjbjbjbjbjbjbjbjbjbj
bjbjbjbjbjbjbjbjbjjgoqoqwiDsDsDsDsDswioqoqoqoqwiwiwiwiwiwiwiwiwiwiwiwiDsDsDsDsDswigYgxgxgxgxgxgxgxgxgxgxgxgxgxgYwiDsDsDsDsDsDsDsDsDswioqoqoqoqwiDsDsDsDsDsDsDswioqoqwiDsDsDsDsDsjgbjbjbjbjbjbjbjbjbjbjbj
bjbjbjbjbjbjbjbjbjjgoqoqwiDsDsDsDsDswioqoqoqoqgYgYgYgYgYgYgYgYgYgYgYwiwiwiwiwiwiwigYgxgxgxgxgxgxgxgxgxgxgxgxgxgYwiwiwiwiwiwiwiwiwiwiwioqoqoqoqwiDsDsDsDsDsDsDswioqoqwiDsDsDsDsDsjgbjbjbjbjbjbjbjbjbjbjbj
bjbjbjbjbjbjbjbjbjjgoqoqwiDsDsDsDsDswioqoqoqoqgYgxgxgxgxgxgxgxgxgxgYgYgYgYgYgYgYgYgYgxgxgxgxgxgxgxgxgxgxgxgxgxgYgYgYgYgYgYgYgYgYgYgYgYoqoqoqoqwiDsDsDsDsDsDsDswioqoqwiDsDsDsDsDsjgbjbjbjbjbjbjbjbjbjbjbj
bjbjbjbjbjbjbjbjbjjgoqoqwiDsDsDsDsDswioqoqoqoqgYgxgxgxgxgxgxgxgxgxgxgxgxgxgxgxgxgxgxgxgxgxgxgxgxgxgxgxgxgxgxgxgxgxgxgxgxgxgxgxgxgxgxgYoqoqoqoqwiDsDsDsDsDsDsDswioqoqwiDsDsDsDsDsjgbjbjbjbjbjbjbjbjbjbjbj
bjbjbjbjbjbjbjbjbjjgoqoqwiDsDsDsDsDswioqoqoqoqgYgxgxgxgxgxgxgxgxgxgxgxgxgxgxgxgxgxgxgxgxgxgxgxgxgxgxgxgxgxgxgxgxgxgxgxgxgxgxgxgxgxgxgYoqoqoqoqwiDsDsDsDsDsDsDswioqoqwiDsDsDsDsDsjgbjbjbjbjbjbjbjbjbjbjbj
bjbjbjbjbjbjbjbjbjjgoqoqwiDsDsDsDsDswioqoqoqoqgYgxgxgxgxgxgxgxgxgxgxgxgxgxgxgxgxgxgxgxgxgxgxgxgxgxgxgxgxgxgxgxgxgxgxgxgxgxgxgxgxgxgxgYoqoqoqoqwiDsDsDsDsDsDsDswioqoqwiDsDsDsDsDsjgbjbjbjbjbjbjbjbjbjbjbj
bjbjbjbjbjbjbjbjbjjgoqoqwiDsDsDsDsDswioqoqoqoqgYgYgYgYgYgYgYgYgYgYgYgYgYgYgYgYgYgYgYgYgYgYgYgYgYgYgYgYgYgYgYgYgYgYgYgYgYgYgYgYgYgYgYgYoqoqoqoqwiwiwiwiwiwiwiwiwioqoqwiwiwiwiwiwijgjgjgjgjgjgjgjgjgjgjgbj
bjbjbjbjbjbjbjbjbjjgoqoqwiDsDsDsDsDswioqoqoqoqoqoqoqoqoqoqoqoqoqoqoqoqoqoqoqoqoqoqoqoqoqoqoqoqoqoqoqoqoqoqoqoqoqoqoqoqoqoqoqoqoqoqoqoqoqoqoqoqoqoqoqoqoqoqoqoqoqoqoqoqoqoqoqoqoqoqoqoqoqZHPyhDhDhDWCZHbj
bjbjbjbjbjbjbjbjjgjgoqoqwiwiwiwiwiwiwioqoqoqoqoqoqoqoqoqoqoqoqoqoqoqoqoqoqoqoqoqoqoqoqoqoqoqoqoqoqoqoqoqoqoqoqoqoqoqoqoqoqoqoqoqoqoqoqoqoqoqoqoqoqoqoqoqoqoqoqoqoqoqoqoqoqoqoqoqoqoqoqoqZHkZdCdCdCsnZHbj
bjbjbjbjbjbjbjbjjgoqoqoqoqoqoqoqoqoqoqoqoqoqoqoqoqoqoqoqoqoqoqoqoqoqoqoqoqoqoqoqoqoqoqoqoqoqoqoqoqoqoqoqoqoqoqoqoqoqoqoqoqoqoqoqoqoqoqoqoqoqoqoqoqoqoqoqoqoqoqoqoqoqoqoqoqoqoqoqoqoqoqoqZHkZdCdCdCsnZHbj
bjbjbjbjbjbjbjbjjgoqoqoqoqoqoqoqoqoqoqoqoqoqoqoqoqoqoqoqoqoqoqoqoqoqoqoqoqoqoqoqoqoqoqoqoqoqoqoqoqoqoqoqoqoqoqoqoqoqoqoqoqoqoqoqoqoqoqoqoqoqoqoqoqoqoqoqoqoqoqoqoqoqoqoqoqoqoqoqoqoqoqoqZHFqOzOzOzBEZHbj
bjbjbjbjbjbjbjbjjgoqoqjgjgjgjgjgjgjgjgoqoqwiwiwiwiwiwiwiwiwiwiwiwiwiwioqoqwiwiwiwiwiwiwiwiwiwiwiwiwiwiwiwiwiwiwioqoqwiwiwiwiwiwiwiwiwigYgYgYgYgYgYgYgYgYgYgYgYgYgYgYgYgYgYgYgYgYgYgYgYgYjgjgjgjgjgjgjgbj
bjbjbjbjbjbjbjbjjgoqoqjgbjbjbjbjbjbjjgoqoqwiDsDsDsDsDsDsDsDsDsDsDsDswioqoqwiDsDsDsDsDsDswiDsDsDsDsDsDsDsDsDsDswioqoqwiDsDsDsDsDsDsDswigYgxgxgxgxgxgxgxgxgxgxgxgxgxgxgxgxgxgxgxgxgxgxgxgYjgbjbjbjbjbjbjbj
bjbjbjbjbjbjbjbjjgoqoqjgbjbjbjbjbjbjjgoqoqwiDsDsDsDsDsDsDsDsDsDsDsDswioqoqwiDsDsDsDsDsDswiDsDsDsDsDsDsDsDsDsDswioqoqwiDsDsDsDsDsDsDswigYgYgYgYgYgYgYgYgYgYgYgYgYgYgYgYgYgYgYgxgxgxgxgxgYjgbjbjbjbjbjbjbj
bjbjbjbjbjbjbjbjjgoqoqjgbjbjbjbjbjbjjgoqoqwiDsDsDsDsDsDsDsDsDsDsDsDswioqoqwiDsDsDsDsDsDswiDsDsDsDsDsDsDsDsDsDswioqoqwiDsDsDsDsDsDsDswiwiwiwiwiwiwiwiwiwiwiwiwiwiwiwiwiwiwigYgxgxgxgxgxgYjgbjbjbjbjbjbjbj
bjbjbjbjbjbjbjbjjgoqoqjgjgjgjgjgjgjgjgoqoqwiDsDsDsDsDsDsDsDsDsDsDsDswioqoqwiDsDsDsDsDsDswiDsDsDsDsDsDsDsDsDsDswioqoqwiDsDsDsDsDsDsDswiDsDsDsDsDsDsDsDsDsDsDswiDsDsDsDsDswigYgxgYgYgYgYgYjgbjbjbjbjbjbjbj
bjbjbjbjbjbjbjbjjgoqoqoqoqoqoqoqoqoqoqoqoqwiDsDsDsDsDsDsDsDsDsDsDsDswioqoqwiDsDsDsDsDsDswiDsDsDsDsDsDsDsDsDsDswioqoqwiDsDsDsDsDsDsDswiDsDsDsDsDsDsDsDsDsDsDswiDsDsDsDsDswigYgxgYjgjgjgjgjgbjbjbjbjbjbjbj
bjbjbjbjbjbjbjbjjgoqoqoqoqoqoqoqoqoqoqoqoqwiDsDsDsDsDsDsDsDsDsDsDsDswioqoqwiDsDsDsDsDsDswiDsDsDsDsDsDsDsDsDsDswioqoqwiDsDsDsDsDsDsDswiDsDsDsDsDsDsDsDsDsDsDswiDsDsDsDsDswigYgxgYjgbjbjbjbjbjbjbjbjbjbjbj
bjbjbjbjbjbjbjbjjgjgjgjgjgjgjgjgjgjgjgoqoqwiDsDsDsDsDsDsDsDsDsDsDsDswioqoqwiDsDsDsDsDsDswiwiwiwiwiwiwiwiwiwiwiwioqoqwiDsDsDsDsDsDsDswiDsDsDsDsDsDsDsDsDsDsDswiDsDsDsDsDswigYgxgYjgbjbjbjbjbjbjbjbjbjbjbj
bjbjbjbjbjbjbjbjbjbjbjbjbjbjbjbjbjbjjgoqoqwiwiwiwiDsDsDsDsDsDswiwiwiwioqoqwiwiwiwiwiwiwiwioqoqoqoqoqoqoqoqoqoqoqoqoqwiDsDsDsDsDsDsDswiDsDsDsDsDsDsDsDsDsDsDswiDsDsDsDsDswigYgxgYjgbjbjbjbjbjbjbjbjbjbjbj
bjbjbjbjbjbjbjbjbjbjbjbjbjbjbjbjbjbjjgoqoqoqoqoqwiDsDsDsDsDsDswioqoqoqoqoqoqoqoqoqoqoqoqoqoqoqoqoqoqoqoqoqoqoqoqoqoqwiDsDsDsDsDsDsDswiDsDsDsDsDsDsDsDsDsDsDswiDsDsDsDsDswigYgYgYjgbjbjbjbjbjbjbjbjbjbjbj
bjbjbjbjbjbjbjbjbjbjbjbjbjbjbjbjbjbjjgoqoqoqoqoqwiDsDsDsDsDsDswioqoqoqoqoqoqoqoqoqoqoqoqoqoqoqjgjgjgjgjgjgjgjgjgoqoqjgjgjgjgjgjgjgjgjgjgjgjgjgjgjgjgjgjgjgjgjgjgjgjgjgjgjgjggYgYjgbjbjbjbjbjbjbjbjbjbjbj
bjbjbjbjbjbjbjbjbjbjbjbjbjbjbjbjbjbjjgjgjgjgoqoqwiDsDsDsDsDsDswioqoqjgjgjgjgjgjgjgjgjgjgjgjgjgjgbjbjbjbjbjbjbjjgoqoqoqoqoqoqoqoqoqoqoqoqoqoqoqoqoqoqoqoqoqoqoqoqoqoqoqoqoqoqoqoqjgbjbjbjbjbjbjbjbjbjbjbj
bjbjbjbjbjbjbjbjbjbjbjbjbjbjbjbjbjbjbjbjbjjgoqoqwiwiwiwiwiwiwiwioqoqjgbjbjbjbjbjbjbjbjbjbjbjbjbjbjbjbjbjbjbjbjjgoqoqoqoqoqoqoqoqoqoqoqoqoqoqoqoqoqoqoqoqoqoqoqoqoqoqoqoqoqoqoqoqjgbjbjbjbjbjbjbjbjbjbjbj
bjbjbjbjbjbjbjbjbjbjbjbjbjbjbjbjbjbjbjbjbjjgoqoqoqoqoqoqoqoqoqoqoqoqjgbjbjbjbjbjbjbjbjbjbjbjbjbjbjbjbjbjbjbjbjjgjgjgjgjgjgjgjgjgjgjgjgjgjgjgjgjgjgjgjgjgjgjgjgjgjgjgjgjgjgjgjgjgjgbjbjbjbjbjbjbjbjbjbjbj
bjbjbjbjbjbjbjbjbjbjbjbjbjbjbjbjbjbjbjbjbjjgoqoqoqoqoqoqoqoqoqoqoqoqjgbjbjbjbjbjbjbjbjbjbjbjbjbjbjbjbjbjbjbjbjbjbjbjbjbjbjbjbjbjbjbjbjbjbjbjbjbjbjbjbjbjbjbjbjbjbjbjbjbjbjbjbjbjbjbjbjbjbjbjbjbjbjbjbjbj
bjbjbjbjbjbjbjbjbjbjbjbjbjbjbjbjbjbjbjbjbjjgjgjgjgjgjgjgjgjgjgjgjgjgjgbjbjbjbjbjbjbjbjbjbjbjbjbjbjbjbjbjbjbjbjbjbjbjbjbjbjbjbjbjbjbjbjbjbjbjbjbjbjbjbjbjbjbjbjbjbjbjbjbjbjbjbjbjbjbjbjbjbjbjbjbjbjbjbjbj
"}
